XXXXXXXXXXX
XXFXXXXX XX
XX XXXXX XX
XX XXXXX XX
XX XXXXX XX
XX       XX
XX   XXX XX
XX       XX
XX  X XXXXX
XX  X XXXXX
XX XX XX XX
XX XX XX XX
XX XSXXXXXX
XX   XXXXXX
XXXXXXXXXXX